
0 2 2 1 2 2 6 #
3 1 3 6 2 2 6 #
1 2 1 6 1 2 6 #
2 2 3 1 3 2 6 #
1 3 2 2 5 2 6 #
1 3 2 2 2 2 6 #
6 6 6 6 6 6 6 #