
1 1 1 1 8 1 1 #
1 1 1 1 1 1 1 #
9 1 24 1 25 1 1 #
9 1 1 0 1 1 1 #
1 1 2 1 1 1 1 #
9 9 10 1 1 1 1 #
9 9 1 1 1 1 5 #